1111111111111
10010010000C1
1000000111101
1P1011E000001
1111111111111