1111111111111111111111111111111111
1000P0000000000E000000C00000000011
1111111111111111111111111111111111