1111111111111111111111111111111111
1000P0000000000000000C00E000000011
1111111111111111111111111111111111
