11111111111111
1P00000C00E001
11111111111111